111111111111111111111111111111111
1P0000000000000001100000000000001
1000C0000000000001100000000000001
100000C000000000011000C0000000001
10000000000C000001100000000000001
1000000000E00000C0100000000000001
111111111111111111111111111111111